######################################
#------------------------------------#
#------------------------------------#
#-----#####--------------------------#
#-----#------------------------------#
#-----#------------------------------#
#-----#------------------------------#
#-----#---------###########----------#
#-----#---------#---------#----------#
#---------------#---------#----------#
#---------------#---------#----------#
#---------------#####-#####----------#
#------------------------------------#
######################################