------------------------------------
------------------------------------
-----#####--------------------------
-----#------------------------------
-----#------------------------------
-----#------------------------------
-----#---------###########----------
-----#---------#---------#----------
---------------#---------#----------
---------------#---------#----------
---------------#####-#####----------
------------------------------------